NO assets/floor.xpm
SO assets/eagle.xpm
WE assets/wall_2.xpm
EA assets/back.xpm

F 9, 169, 182
C 234, 213, 218

11111111
10000001
10052001
10000001
13100001
10000001
1000N001
11111111
