NO assets/eagle.xpm
SO assets/greystone.xpm
WE assets/colorstone.xpm
EA assets/back.xpm

F 170, 65, 19
C 104, 182, 68

11111111111111111111
10000001000000100001
10000001000000100001
10000001000000100001
10000001000000300111
10000001000000100001
11111000001111100001
10000001000000100001
10000001000000100001
10000001000000100001
11111111311111111111
10200100001000100001
10000000003000100001
10000100001000000001
100S0100001000000001
11011110111111011111
10000100001000010001
10000100001000030001
10000100001000010001
11111111111111111111
